A chilling wind blows in the late afternoon.

Coming Home
An Interactive Fiction by Alexandre, Douglas and Lincoln
Release 1 / Serial number 200704 / Inform 7 build 6M62 (I6/v6.33 lib 6/12N) SD

Porch
You can see Main door, Main key, Wooden chair and Old box (in which is candle) here.

>examine box
In Old box are candle and string.

* * *

A chilling wind blows in the late afternoon.

Coming Home
An Interactive Fiction by Alexandre, Douglas and Lincoln
Release 1 / Serial number 200704 / Inform 7 build 6M62 (I6/v6.33 lib 6/12N) SD

Porch
You can see Main door, Main key, Wooden chair and Old box (in which is candle) here.

>look
Porch
You can see Main door, Main key, Wooden chair and Old box (in which are candle and string) here.

>get key
A chill runs up your spine.

Taken.

>get old box
Taken.

* * *

>get key
A chill runs up your spine.

Taken.

>get box
Taken.

>unlock door with key
You unlock Main door.

>enter door
(first opening Main door)

Hall
You can see Gray door, Main door, Red door and Noah here.

The door closes in a bump and the key disappears from the lock. The inside smells as bad news...

You hear a bark coming from the Red door.

Someone is crying upstairs.

>talk noah
That's not a verb I recognise.

>speak noah
(to yourself)
There is no reply.

>wave noah
But you aren't holding that.

>wave
You wave.

>look
Hall
You can see Main door and Noah here.

* * *

>enter door
(first opening Main door)

Hall
You can see Gray door, Main door, Red door and Noah here.

The door closes in a bump and the key disappears from the lock. The inside smells as bad news...

You hear a bark coming from the Red door.

Someone is crying upstairs.

>enter red door
(first opening Red door)

Living Room
Descrição do Living Room.

You can see White door, Red door, Brown door, Yellow door, Josh and Apolo here.

A Labradors barks to. From his dog collar, you see his name must be Apolo.

>enter red door
Hall
You can see Red door, Gray door, Main door and Noah here.

>enter red door
Living Room
Descrição do Living Room.

You can see Red door, White door, Brown door, Yellow door, Josh and Apolo here.

* * *

>enter red door
(first opening Red door)

Living Room
Descrição do Living Room.

You can see White door, Red door, Brown door, Yellow door, Josh and Apolo here.

A Labradors barks to. From his dog collar, you see his name must be Apolo.

>enter brown door
(first opening Brown door)

Garage
Descrição da Garage.

You can see Brown door, Orange door, Plastic bag (in which is Dog whistle) and Cardboard box here.

>look
Garage
Descrição da Garage.

You can see Brown door and Orange door here.

>inspect box
That's not a verb I recognise.

>get box
You already have that.

>get cabinet
You can't see any such thing.

* * *

>enter brown door
(first opening Brown door)

Garage
Descrição da Garage.

You can see Brown door, Orange door, Plastic bag (in which is Dog whistle) and Cardboard box here.

>get plastic bag
Taken.

>whistle dog
A shrill whistle echoes through the house and you hear a dog approaching!

>look
Garage
Descrição da Garage.

You can see Apolo, Brown door, Orange door and Cardboard box here.

* * *

>unlock door with key
You unlock Main door.

>enter key
That's not something you can enter.

>enter door
(first opening Main door)

Hall
You can see Main door and Noah here.

The door closes in a bump and the key disappears from the lock. The inside smells as bad news...

You hear a bark coming from a room next to you.

Someone is crying upstairs.

>inventory
You are carrying:
  Old box
    candle
    string
  Main key

>enter door
Porch
You can see Main door and Wooden chair here.

>enter door
Hall
You can see Main door and Noah here.

* * *

>get box
Taken.

>unlock door
What do you want to unlock Main door with?

>unlock door with key
You unlock Main door.

* * *

>enter red door
(first opening Red door)

Living Room
Descrição do Living Room.

You can see White door, Red door, Brown door, Yellow door, Josh and Apolo here.

A Labradors barks to. From his dog collar, you see his name must be Apolo.

>enter brown door
(first opening Brown door)
It seems to be locked.

* * *

>look
Porch
You can see Main door, Main key, Wooden chair and Old box (in which are candle and string) here.

>get box
Taken.

>get key
A chill runs up your spine.

Taken.

>unlock door
What do you want to unlock Main door with?

* * *

>unlock door with key
You unlock Main door.

>enter door
(first opening Main door)

Hall
You can see Main door and Noah here.

The door closes in a bump and the key disappears from the lock. The inside smells as bad news...

>talk noah
That's not a verb I recognise.

* * *

A chilling wind blows in the late afternoon.

Coming Home
An Interactive Fiction by Alexandre, Douglas and Lincoln
Release 1 / Serial number 200704 / Inform 7 build 6M62 (I6/v6.33 lib 6/12N) SD

Porch
You can see Main door, Main key, Wooden chair and Old box (in which is candle) here.

>get key
A chill runs up your spine.

Taken.

* * *

>unlock door with key
You unlock Main door.

>enter door
(first opening Main door)

Hall
You can see Gray door, Main door, Red door and Noah here.

The door closes in a bump and the key disappears from the lock. The inside smells as bad news...

You hear a bark coming from a room next to you.

Someone is crying upstairs.

>enter red door
(first opening Red door)

Living Room
Descrição do Living Room.

You can see White door, Red door, Brown door, Yellow door, Josh and Apolo here.

* * *

>get box
Taken.

>look
Porch
You can see Main door and Wooden chair here.

>unlock door with key
You unlock Main door.

* * *

>enter door
(first opening Main door)

Hall
You can see Gray door, Main door, Red door and Noah here.

The door closes in a bump and the key disappears from the lock. The inside smells as bad news...

You hear a bark coming from the Red door.

Someone is crying upstairs.

>enter gray door
(first opening Gray door)
It seems to be locked.

I beg your pardon?

>enter red door
(first opening Red door)

Living Room
Descrição do Living Room.

You can see White door, Red door, Brown door, Yellow door, Josh and Apolo here.

A Labradors barks to. From his dog collar, you see his name must be Apolo.

* * *

>look
Garage
Descrição da Garage.

You can see Apolo, Brown door, Orange door and Cardboard box here.

>whistle dog
A shrill whistle echoes through the house and you hear a dog approaching!

* * *

A chilling wind blows in the late afternoon.

Coming Home
An Interactive Fiction by Alexandre, Douglas and Lincoln
Release 1 / Serial number 200704 / Inform 7 build 6M62 (I6/v6.33 lib 6/12N) SD

Porch
You can see Main door, Main key, Wooden chair and Old box (in which is candle) here.

>get box
Taken.

* * *

>get key
A chill runs up your spine.

Taken.

>unlock door with key
You unlock Main door.

* * *

>get plastic bag
Taken.

>enter brown door
Living Room
Descrição do Living Room.

You can see Brown door, White door, Red door, Yellow door, Josh and Apolo here.

>enter red door
Hall
You can see Red door, Gray door, Main door and Noah here.

>whistle dog
A shrill whistle echoes through the house but nothing happens. You should use it somewhere else.

* * *

A chilling wind blows in the late afternoon.

Coming Home
An Interactive Fiction by Alexandre, Douglas and Lincoln
Release 1 / Serial number 200704 / Inform 7 build 6M62 (I6/v6.33 lib 6/12N) SD

Porch
You can see Main door, Main key, Wooden chair and Old box (in which is candle) here.

>take key
A chill runs up your spine.

Taken.

>enter door
(first opening Main door)
It seems to be locked.

>unlock door
(with Main key)
You unlock Main door.

>enter door
(first opening Main door)

Hall
You can see Gray door, Main door, Red door and Noah here.

The door closes in a bump and the key disappears from the lock. The inside smells as bad news...

You hear a bark coming from the Red door.

Someone is crying upstairs.

>look
Hall
You can see Gray door, Main door, Red door and Noah here.

>enter staircase
Upper Hall
Descrição do Upper Hall.

You can see Heart-painted door, Purple door, Black door, Scratched door and Lilie here.

>talk to lilie
That's not a verb I recognise.

>speak to Lilie
I didn't understand that sentence.

>speak Lilie
(to yourself)
There is no reply.

>enter Stairs
Hall
You can see Gray door, Main door, Red door and Noah here.

>enter gray door
(first opening Gray door)
It seems to be locked.

>enter red door
(first opening Red door)

Living Room
Descrição do Living Room.

You can see White door, Red door, Brown door, Yellow door, Josh and Apolo here.

A Labradors barks to. From his dog collar, you see his name must be Apolo.

* * *

>enter brown door
(first opening Brown door)

Garage
Descrição da Garage.

You can see Brown door, Orange door, Plastic bag (in which is Dog whistle) and Cardboard box here.

>enter brown door
Living Room
Descrição do Living Room.

You can see Brown door, White door, Red door, Yellow door, Josh and Apolo here.

>enter white door
(first opening White door)
It seems to be locked.

>enter yellow door
(first opening Yellow door)

Dining Room
Descrição do Dining Room.

You can see Yellow door and Green door here.

* * *

>take key
A chill runs up your spine.

Taken.

>unlock door
(with Main key)
You unlock Main door.

>enter door
(first opening Main door)

Hall
You can see Gray door, Main door, Red door and Noah here.

The door closes in a bump and the key disappears from the lock. The inside smells as bad news...

A man in his mid-thirties says, "Hello, I'm Noah! it's been a while since our we've had a visitor. Make yourself comfortable."

You hear a bark coming from the Red door.

Someone is crying upstairs.

>enter red door
(first opening Red door)

Living Room
Descrição do Living Room.

You can see White door, Red door, Brown door, Yellow door, Josh and a dog here.

A Labrador barks. From his dog collar, you see his name must be Apolo.

A blind man says, "Hey! How're you doing? I seem to have lost my dog whistle, it's pretty useful to call Apolo whenever he's wandering somewhere else around the house."

The place looks very messy. Maybe someone was looking for something here.

>enter yellow door
(first opening Yellow door)

Dining Room
Descrição do Dining Room.

You can see Yellow door and Green door here.

>enter yellow door
Living Room
Descrição do Living Room.

You can see Yellow door, White door, Red door, Brown door, Josh and Apolo here.

>enter Gray door
You can't see any such thing.

>enter gray door
You can't see any such thing.

>look
Living Room
Descrição do Living Room.

You can see Yellow door, White door, Red door, Brown door, Josh and Apolo here.

>enter brown door
(first opening Brown door)

Garage
Descrição da Garage.

You can see Brown door, Orange door, Plastic bag (in which is Dog whistle) and Cardboard box here.

>take dog whistle
Taken.

>enter brown door
Living Room
Descrição do Living Room.

You can see Brown door, Yellow door, White door, Red door, Josh and Apolo here.

>enter yellow door
Dining Room
Descrição do Dining Room.

You can see Yellow door and Green door here.

>enter yellow door
Living Room
Descrição do Living Room.

You can see Yellow door, Brown door, White door, Red door, Josh and Apolo here.

>enter white door
(first opening White door)
It seems to be locked.

* * *

>enter yellow door
Living Room
Descrição do Living Room.

You can see Yellow door, White door, Red door, Brown door, Josh and Apolo here.

>enter brown door
(first opening Brown door)

Garage
Descrição da Garage.

You can see Brown door, Orange door, Plastic bag (in which is Dog whistle) and Cardboard box here.

* * *

>take dog whistle
Taken.

>look
Garage
Descrição da Garage.

You can see Brown door, Orange door, Plastic bag (empty) and Cardboard box here.

>enter brown door
Living Room
Descrição do Living Room.

You can see Brown door, Yellow door, White door, Red door, Josh and Apolo here.

* * *

>enter yellow door
Dining Room
Descrição do Dining Room.

You can see Yellow door and Green door here.

>whistle dog whistle
A shrill whistle echoes through the house but nothing happens. You should use it somewhere else.

* * *

>enter door
(first opening Main door)

Hall
You can see Gray door, Main door, Red door and Noah here.

The door closes in a bump and the key disappears from the lock. The inside smells as bad news...

A man in his mid-thirties says, "Hello, I'm Noah! it's been a while since our we've had a visitor. Make yourself comfortable."

You hear a bark coming from the Red door.

Someone is crying upstairs.

>ask noah about the house
Well, isn't this house lovely! Feel free to explore it and enjoy your stay for as long as you like

>enter red door
(first opening Red door)

Living Room
Descrição do Living Room.

You can see White door, Red door, Brown door, Yellow door, Josh and a dog here.

A Labrador barks. From his dog collar, you see his name must be Apolo.

A blind man says, "Hey! How're you doing? I seem to have lost my dog whistle, it's pretty useful to call Apolo whenever he's wandering somewhere else around the house."

>enter dinning room
You can't see any such thing.

>enter yellow door
(first opening Yellow door)

Dining Room
Descrição do Dining Room.

You can see Yellow door and Green door here.

The place looks very messy. Maybe someone was looking for something here.

>enter yellow door
Living Room
Descrição do Living Room.

You can see Yellow door, White door, Red door, Brown door, Josh and a dog here.

>ask josh about the dining room
Josh: I think Noah missed something over there.  I believe it is something important.

* * *

>unlock door
(with Main key)
You unlock Main door.

>open door
You open Main door.

>enter door
Hall
You can see Gray door, Main door, Red door and Noah here.

The door closes in a bump and the key disappears from the lock. The inside smells as bad news...

A man in his mid-thirties says, "Hello, I'm Noah! it's been a while since our we've had a visitor. Make yourself comfortable."

You hear a bark coming from the Red door.

Someone is crying upstairs.

>enter red door
(first opening Red door)

Living Room
Descrição do Living Room.

You can see White door, Red door, Brown door, Yellow door, Josh and a dog here.

A Labrador barks. From his dog collar, you see his name must be Apolo.

A blind man says, "Hey! How're you doing? I seem to have lost my dog whistle, it's pretty useful to call Apolo whenever he's wandering somewhere else around the house."

>enter brown door
(first opening Brown door)

Garage
Apparently no one's been here in weeks. In addition to a big mess and several thrown junk, you notice that the garage gate has a lever.

You can see Brown door, Orange door, Garage gate, Plastic bag (in which is Whistle), Cardboard box and Lever here.

>take dog whistle
You can't see any such thing.

>enter yellow door
You can't see any such thing.

>look
Garage
Apparently no one's been here in weeks. In addition to a big mess and several thrown junk, you notice that the garage gate has a lever.

You can see Brown door, Orange door, Garage gate, Plastic bag (in which is Whistle), Cardboard box and Lever here.

>take whistle
Taken.

>look
Garage
Apparently no one's been here in weeks. In addition to a big mess and several thrown junk, you notice that the garage gate has a lever.

You can see Brown door, Orange door, Garage gate, Plastic bag (empty), Cardboard box and Lever here.

>enter yellow door
You can't see any such thing.

>inventory
You are carrying:
  Whistle

>look
Garage
Apparently no one's been here in weeks. In addition to a big mess and several thrown junk, you notice that the garage gate has a lever.

You can see Brown door, Orange door, Garage gate, Plastic bag (empty), Cardboard box and Lever here.

* * *

>enter yellow door
You can't see any such thing.

>look
Garage
Apparently no one's been here in weeks. In addition to a big mess and several thrown junk, you notice that the garage gate has a lever.

You can see Brown door, Orange door, Garage gate, Plastic bag (empty), Cardboard box and Lever here.

* * *

>enter yellow door
You can't see any such thing.

>enter brown door
Living Room
Descrição do Living Room.

You can see Brown door, White door, Red door, Yellow door, Josh and a dog here.

>enter yellow door
(first opening Yellow door)

Dining Room
Descrição do Dining Room.

You can see Yellow door and Green door here.

The place looks very messy. Maybe someone was looking for something here.

>enter yellow door
Living Room
Descrição do Living Room.

You can see Yellow door, Brown door, White door, Red door, Josh and a dog here.

>ask josh about the dining room
Josh:  Acho que Noah perdeu algo importante por lá, entretanto, Toda vez que o Apolo passa por lá ele fica bem agitado.

>enter yellow door
Dining Room
Descrição do Dining Room.

You can see Yellow door and Green door here.

>whistle dog whistle
You can't see any such thing.

>look
Dining Room
Descrição do Dining Room.

You can see Yellow door and Green door here.

>whistle dog whistle
You can't see any such thing.

>inventory
You are carrying:
  Whistle

>look
Dining Room
Descrição do Dining Room.

You can see Yellow door and Green door here.

* * *

>whistle dog whistle
You can't see any such thing.

>whistle
(Whistle)
A shrill whistle echoes through the house and you hear a dog approaching! Apollo suddenly starts to bark. It looks like he found something

>look
Dining Room
Descrição do Dining Room.

You can see Little Box (in which is a Heartshaped key), a dog, Yellow door and Green door here.

>take heartshaped key
Taken.

>enter yellow door
Living Room
Descrição do Living Room.

You can see Yellow door, Brown door, White door, Red door and Josh here.

>enter red door
Hall
You can see Red door, Gray door, Main door and Noah here.

>ask noah about the dining room
Noah fica em silencio e parece preocupado.

>enter Stairs
Upper Hall
Descrição do Upper Hall.

You can see Heart-painted door, Purple door, Black door, Scratched door and Lilie here.

A girl scaredly says, "Have you seen my teddy bear? I don't go anywhere without it.... 
 I don't remember where I left it, but it's probably somewhere on the second floor."

>enter heart-painted door
(first opening Heart-painted door)
It seems to be locked.

>unlock
What do you want to unlock?

>heartshaped key
What do you want to unlock the Heartshaped key with?

>nothing
You can't see any such thing.

>unlock heart-painted dooor
I didn't understand that sentence.

>unlock heart-painted door
What do you want to unlock Heart-painted door with?

>inventory
You are carrying:
  a Heartshaped key
  Whistle

>heartshaped key
That's not a verb I recognise.

>a heartshaped key
That's not a verb I recognise.

>heartshaped key
That's not a verb I recognise.

>unlock heart-painted door with hartshaped key
You can't see any such thing.

>unlock heart-painted door
What do you want to unlock Heart-painted door with?

>Heartshaped key
You unlock Heart-painted door.

>enter heart-painted door
(first opening Heart-painted door)

Medium Bedroom
Descrição do Medium Bedroom.

You can see Heart-painted door and Jewelry Case (in which is necklace) here.

>take necklace
Você tem uma sensação estranha a respeito deste colar. Noah: A perfeito voce encontrou meu colar. Agora me devolva para que eu possa guarda-lo.

Taken.